{
  "1": {
    "id": "m1",
    "grid": [
      ["1","1","1","1","1","1","1","1","1","1"],
      ["1","0","0","0","0","0","0","0","0","1"],
      ["1","2","0","0","0","0","0","0","0","1"],
      ["1","0","0","0","0","0","0","0","0","1"],
      ["1","0","0","0","0","0","0","0","0","1"],
      ["1","0","0","0","0","0","0","0","0","1"],
      ["1","0","0","0","0","0","0","0","0","1"],
      ["1","0","0","0","0","0","0","0","0","1"],
      ["1","0","0","0","0","0","0","0","0","1"],
      ["1","0","0","0","0","0","0","0","0","1"],
      ["1","0","0","0","0","0","0","0","0","1"],
      ["1","0","0","0","LE","0","0","0","0","1"],
      ["1","0","0","0","0","0","0","0","0","1"],
      ["1","0","0","0","0","0","0","0","G","1"],
      ["1","1","1","1","1","1","1","1","1","1"]
    ]
  },
  "2": {
    "id": "m2",
    "grid": [
      ["1","1","1","1","1","1","1","1","1","1"],
      ["1","0","0","0","1","0","0","0","G","1"],
      ["1","2","0","0","1","0","0","0","0","1"],
      ["1","0","0","0","0","0","0","0","0","1"],
      ["1","0","0","0","0","0","0","0","0","1"],
      ["1","0","0","0","0","0","0","LE","0","1"],
      ["1","0","0","0","1","0","0","0","0","1"],
      ["1","0","0","0","1","0","0","0","0","1"],
      ["1","0","0","0","1","0","0","1","1","1"],
      ["1","0","0","0","1","0","0","0","0","1"],
      ["1","0","0","0","1","0","0","0","0","1"],
      ["1","0","LE","0","0","0","0","LE","0","1"],
      ["1","0","0","0","0","0","0","0","0","1"],
      ["1","0","0","0","0","0","0","0","0","1"],
      ["1","1","1","1","1","1","1","1","1","1"]
    ]
  },
  "3": {
    "id": "m3",
    "grid": [
      ["1","1","1","1","1","1","1","1","1","1"],
      ["1","0","0","0","1","0","0","1","G","1"],
      ["1","2","0","0","1","0","0","1","0","1"],
      ["1","0","0","LE","0","0","0","1","0","1"],
      ["1","0","0","0","1","0","0","1","0","1"],
      ["1","0","0","0","1","0","0","1","0","1"],
      ["1","0","0","0","1","0","1","1","0","1"],
      ["1","1","1","1","1","0","0","1","0","1"],
      ["1","0","0","0","0","0","0","1","0","1"],
      ["1","0","0","0","0","0","0","1","0","1"],
      ["1","0","HU","0","0","0","0","1","0","1"],
      ["1","0","0","0","0","0","0","0","0","1"],
      ["1","0","0","0","0","0","LE","0","0","1"],
      ["1","0","0","0","0","0","0","0","0","1"],
      ["1","1","1","1","1","1","1","1","1","1"]
    ]
  },
    "4": {
    "id": "m4",
    "grid": [
      ["1","1","1","1","1","1","1","1","1","1"],
      ["1","0","0","0","0","0","0","0","0","1"],
      ["1","2","0","0","0","0","0","0","0","1"],
      ["1","0","0","0","1","0","0","HU","0","1"],
      ["1","0","0","0","1","0","0","0","0","1"],
      ["1","0","LE","0","1","0","0","0","0","1"],
      ["1","0","0","0","1","0","HU","0","0","1"],
      ["1","0","1","1","1","1","1","1","0","1"],
      ["1","0","0","0","1","G","0","0","0","1"],
      ["1","0","0","0","1","0","0","0","0","1"],
      ["1","0","HU","0","1","0","HU","0","0","1"],
      ["1","0","0","0","1","0","0","0","0","1"],
      ["1","0","0","0","0","0","0","0","0","1"],
      ["1","0","0","0","0","0","0","0","0","1"],
      ["1","1","1","1","1","1","1","1","1","1"]
    ]
  },
  "5": {
    "id": "m5",
    "grid": [
      ["1","1","1","1","1","1","1","1","1","1"],
      ["1","0","0","0","0","0","0","0","0","1"],
      ["1","2","0","0","LE","0","1","0","0","1"],
      ["1","1","1","1","1","1","1","0","0","1"],
      ["1","0","0","0","0","0","HU","0","0","1"],
      ["1","0","0","0","1","0","0","0","0","1"],
      ["1","0","0","0","1","0","0","0","HU","1"],
      ["1","0","OR","0","1","0","0","0","0","1"],
      ["1","0","0","0","1","0","0","0","0","1"],
      ["1","0","0","0","0","0","0","0","0","1"],
      ["1","0","0","0","1","1","1","1","1","1"],
      ["1","0","LE","0","0","0","0","0","0","1"],
      ["1","0","0","0","0","OR","0","0","0","1"],
      ["1","0","0","0","0","0","0","0","G","1"],
      ["1","1","1","1","1","1","1","1","1","1"]
    ]
  }
}