{
  "1": {
    "id": "m1",
    "grid": [
      ["1","1","1","1","1","1","1","1","1","1"],
      ["1","0","0","0","0","0","0","0","0","1"],
      ["1","2","0","0","0","0","0","0","0","1"],
      ["1","0","0","0","0","0","0","0","0","1"],
      ["1","0","0","0","0","0","0","0","0","1"],
      ["1","0","0","0","0","0","0","0","0","1"],
      ["1","0","0","0","0","0","0","0","0","1"],
      ["1","0","0","0","0","0","0","0","0","1"],
      ["1","0","0","0","0","0","0","0","0","1"],
      ["1","0","0","0","0","0","0","0","0","1"],
      ["1","0","0","0","0","0","0","0","0","1"],
      ["1","0","0","0","LE","0","0","0","0","1"],
      ["1","0","0","0","0","0","0","0","0","1"],
      ["1","0","0","0","0","0","0","0","0","1"],
      ["1","1","1","1","1","1","1","1","1","1"]
    ]
  },
  "2": {
    "id": "m2",
    "grid": [
      ["1","1","1","1","1","1","1","1","1","1"],
      ["1","0","0","0","0","0","0","0","0","1"],
      ["1","2","0","0","0","0","0","0","0","1"],
      ["1","0","0","0","0","0","0","0","0","1"],
      ["1","0","0","0","0","0","0","0","0","1"],
      ["1","0","0","0","0","0","0","0","0","1"],
      ["1","0","0","0","1","0","0","0","0","1"],
      ["1","0","0","0","0","0","0","0","0","1"],
      ["1","0","0","0","0","0","0","0","0","1"],
      ["1","0","0","0","0","0","0","0","0","1"],
      ["1","0","0","0","0","0","0","0","0","1"],
      ["1","0","0","0","0","0","0","0","0","1"],
      ["1","0","0","0","0","0","0","0","0","1"],
      ["1","0","0","0","0","0","0","0","0","1"],
      ["1","1","1","1","1","1","1","1","1","1"]
    ]
  }
}